Afghanistan -> AFG
Africa -> OWID_AFR
Albania -> ALB
Algeria -> DZA
Andorra -> AND
Angola -> AGO
Anguilla -> AIA
Antigua and Barbuda -> ATG
Argentina -> ARG
Armenia -> ARM
Aruba -> ABW
Asia -> OWID_ASI
Australia -> AUS
Austria -> AUT
Azerbaijan -> AZE
Bahamas -> BHS
Bahrain -> BHR
Bangladesh -> BGD
Barbados -> BRB
Belarus -> BLR
Belgium -> BEL
Belize -> BLZ
Benin -> BEN
Bermuda -> BMU
Bhutan -> BTN
Bolivia -> BOL
Bonaire Sint Eustatius and Saba -> BES
Bosnia and Herzegovina -> BIH
Botswana -> BWA
Brazil -> BRA
British Virgin Islands -> VGB
Brunei -> BRN
Bulgaria -> BGR
Burkina Faso -> BFA
Burundi -> BDI
Cambodia -> KHM
Cameroon -> CMR
Canada -> CAN
Cape Verde -> CPV
Cayman Islands -> CYM
Central African Republic -> CAF
Chad -> TCD
Chile -> CHL
China -> CHN
Colombia -> COL
Comoros -> COM
Congo -> COG
Cook Islands -> COK
Costa Rica -> CRI
Cote d'Ivoire -> CIV
Croatia -> HRV
Cuba -> CUB
Curacao -> CUW
Cyprus -> CYP
Czechia -> CZE
Democratic Republic of Congo -> COD
Denmark -> DNK
Djibouti -> DJI
Dominica -> DMA
Dominican Republic -> DOM
Ecuador -> ECU
Egypt -> EGY
El Salvador -> SLV
England -> OWID_ENG
Equatorial Guinea -> GNQ
Estonia -> EST
Eswatini -> SWZ
Ethiopia -> ETH
Europe -> OWID_EUR
European Union -> OWID_EUN
Faeroe Islands -> FRO
Falkland Islands -> FLK
Fiji -> FJI
Finland -> FIN
France -> FRA
French Polynesia -> PYF
Gabon -> GAB
Gambia -> GMB
Georgia -> GEO
Germany -> DEU
Ghana -> GHA
Gibraltar -> GIB
Greece -> GRC
Greenland -> GRL
Grenada -> GRD
Guatemala -> GTM
Guernsey -> GGY
Guinea -> GIN
Guinea-Bissau -> GNB
Guyana -> GUY
Haiti -> HTI
High income -> OWID_HIC
Honduras -> HND
Hong Kong -> HKG
Hungary -> HUN
Iceland -> ISL
India -> IND
Indonesia -> IDN
Iran -> IRN
Iraq -> IRQ
Ireland -> IRL
Isle of Man -> IMN
Israel -> ISR
Italy -> ITA
Jamaica -> JAM
Japan -> JPN
Jersey -> JEY
Jordan -> JOR
Kazakhstan -> KAZ
Kenya -> KEN
Kiribati -> KIR
Kosovo -> OWID_KOS
Kuwait -> KWT
Kyrgyzstan -> KGZ
Laos -> LAO
Latvia -> LVA
Lebanon -> LBN
Lesotho -> LSO
Liberia -> LBR
Libya -> LBY
Liechtenstein -> LIE
Lithuania -> LTU
Low income -> OWID_LIC
Lower middle income -> OWID_LMC
Luxembourg -> LUX
Macao -> MAC
Madagascar -> MDG
Malawi -> MWI
Malaysia -> MYS
Maldives -> MDV
Mali -> MLI
Malta -> MLT
Mauritania -> MRT
Mauritius -> MUS
Mexico -> MEX
Moldova -> MDA
Monaco -> MCO
Mongolia -> MNG
Montenegro -> MNE
Montserrat -> MSR
Morocco -> MAR
Mozambique -> MOZ
Myanmar -> MMR
Namibia -> NAM
Nauru -> NRU
Nepal -> NPL
Netherlands -> NLD
New Caledonia -> NCL
New Zealand -> NZL
Nicaragua -> NIC
Niger -> NER
Nigeria -> NGA
Niue -> NIU
North America -> OWID_NAM
North Macedonia -> MKD
Northern Cyprus -> OWID_CYN
Northern Ireland -> OWID_NIR
Norway -> NOR
Oceania -> OWID_OCE
Oman -> OMN
Pakistan -> PAK
Palestine -> PSE
Panama -> PAN
Papua New Guinea -> PNG
Paraguay -> PRY
Peru -> PER
Philippines -> PHL
Pitcairn -> PCN
Poland -> POL
Portugal -> PRT
Qatar -> QAT
Romania -> ROU
Russia -> RUS
Rwanda -> RWA
Saint Helena -> SHN
Saint Kitts and Nevis -> KNA
Saint Lucia -> LCA
Saint Vincent and the Grenadines -> VCT
Samoa -> WSM
San Marino -> SMR
Sao Tome and Principe -> STP
Saudi Arabia -> SAU
Scotland -> OWID_SCT
Senegal -> SEN
Serbia -> SRB
Seychelles -> SYC
Sierra Leone -> SLE
Singapore -> SGP
Sint Maarten (Dutch part) -> SXM
Slovakia -> SVK
Slovenia -> SVN
Solomon Islands -> SLB
Somalia -> SOM
South Africa -> ZAF
South America -> OWID_SAM
South Korea -> KOR
South Sudan -> SSD
Spain -> ESP
Sri Lanka -> LKA
Sudan -> SDN
Suriname -> SUR
Sweden -> SWE
Switzerland -> CHE
Syria -> SYR
Taiwan -> TWN
Tajikistan -> TJK
Tanzania -> TZA
Thailand -> THA
Timor -> TLS
Togo -> TGO
Tokelau -> TKL
Tonga -> TON
Trinidad and Tobago -> TTO
Tunisia -> TUN
Turkey -> TUR
Turkmenistan -> TKM
Turks and Caicos Islands -> TCA
Tuvalu -> TUV
Uganda -> UGA
Ukraine -> UKR
United Arab Emirates -> ARE
United Kingdom -> GBR
United States -> USA
Upper middle income -> OWID_UMC
Uruguay -> URY
Uzbekistan -> UZB
Vanuatu -> VUT
Venezuela -> VEN
Vietnam -> VNM
Wales -> OWID_WLS
Wallis and Futuna -> WLF
World -> OWID_WRL
Yemen -> YEM
Zambia -> ZMB
Zimbabwe -> ZWE
